bicycle -> baicicol
camera -> quemeura
watch (relógio de pulso)
clock (relogio de parede )
umbrella -> ambrella
e-reader -> i-rider

table -> é onde agt come
desk -> onde agt usa para trabalhar / estudar
dictionary -> dictionary

each -> iti -> cada

busy -> bizi -> ocupado

these -> quando estamos se referindo a objetos e eles são no plural -> Are THESE CDs? -> PRONUNCIA: DIZi
couch / sofa -> sofa
pillows -> 
rug -> tapete menorzinho
living room -> sala de estar
meeting room -> sala de reuniões
carpet -> Cárpet
floor -> FLÓUR ( CHÃO )
it's an office -> it'sa  noficce
lockers -> armario de universidade ( armarinho )
school hallway -> corredor da escola
because -> porque
Writing -> REDAÇÃO
composition -> REDAÇÃO
Statue of Liberty -> istatue ov Liberti
I think -> eu acho
I Guess -> eu suponho que seja
The United States -> De IuNaited istates
Eiffel Tower -> 
Paulista Avenue -> falamos em ingles apenas a palavra que não é propria, AVENIDA não é nome
Brazil -> BRÃZIL
Egypt -> Edjipt
The United States -> 
Italy -> Italí
Kind of -> "MAIS O MENOS" OU "TIPO DE" depende do contexto
What kind of 
What about you? -> e voce?
I'm pretty good -> o pretty intensifica o good, tipo.. estou MUITO BEM.
often -> muitas vezes
magician -> pronuncia MADICHIAN
a meal -> meal === refeição
sor -> dolorido -> SÓR
love hurts -> O amor doi.
hurts -> machuca
His leg is sore -> A perna dele está doendo.
patient -> paciente -> PAICHIENT
TGIF -> Thank God is Friday -> É SEXTA-FEITA PORRA
i am ugly -> estou feio
shop assistant -> vendedor
guessing -> advinhar
guessing gamer -> jogo de advinhação
young -> jovem
old -> velho
comics -> estórica em quadrinho
wake up -> acordar
get up -> levantar
strech out -> se expreguissar
brush my teeth -> escovar meus dentes
1 tooth -> 1 dente
33 teeth -> 33 dentes
brush my teeth -> escovar meus dentes
dress up -> se vestir
get dressed -> se vestir
take a shower -> tomar banho
hurry up -> se apresse
hurry up, we-re late for work -> se apresse nós estamos atrasado para o trabalho
that happens! -> acontece.. , exemplo... MINHA CADEIRA QUEBROU OMGG.. e ai vc response aa relaxa that happens ( a rlx "isso acontece", fazer o que)
plate -> prato
it's a brazilian dish -> isso é um prato brasileiro
it's pão de queijo -> isso é um pão de queijo
it's acarajé -> isso é um acarajé
it's mortadela sandwitch -> pão de mortadela
pig -> animal porco
pork -> carne de porco agt fala pork

---- TERCEIRA PESSOA -----
	He wakes up
	He gets up
	He brushes his teeth
	He takes a shower
	He dresses up
	He gets dressed
	He goes to work

also e too -> o also agt usa no começo e too agt usa no final, porem ambos tem o mesmo significado ( também )
	i'm a stay-at-home dad, too.
	i'm also a stay-at-home dad.


"idioms" -> procurar depois, são expreções idiomaticas como..

Kick the bucket -> no brasil agt fala chutar o balde, porem na gringa significa que ele/ela morreu



Open the notebook and take notes -> abra seu caderno e anote

so far so good -> até aqui tudo certo

Brazil is a culture melting pot -> o Brazil é uma missigenação ( uma grande mistura de culturas )

Is it correct?
	It is
	Yes, it is

My family is close.

I live with my mother, my grandparents and with my self.




---- How to derscribe your school or office in writing ----

---- How to start a conversation with a foreigner ----
	Como começar uma conversa com um estrangeiro
